WWWWWWWWWWWWWWWWWWWWW
WPPPPPPPPPWPPPPPPPPPW
WPWWWPWWWPWPWWWPWWWPW
WPWWWPWWWPWPWWWPWWWPW
WPPPPPPPPPPPPPPPPPPPW
WPWWWPWPWWWWWPWPWWWPW
WPPPPPWPPPWPPPWPPPPPW
WWWWWPWWWPWPWWWPWWWWW
GGGGWPWPPPPPPPWPWGGGG
WWWWWPWPWWDWWPWPWWWWW
PPPPPPPPWGGGWPPPPPPPP
WWWWWPWPWGGGWPWPWWWWW
GGGGWPWPWWWWWPWPWGGGG
GGGGWPPPPPPPPPPPWGGGG
WWWWWPPPWWWWWPPPWWWWW
WPPPPPPPPPWPPPPPPPPPW
WPWWWPWWWPWPWWWPWWWPW
WPPPWPPPPPGPPPPPWPPPW
WPPPWPWPWWWWWPWPWPPPW
WPPPPPWPPPWPPPWPPPPPW
WPWWWWWWWWPWPWWWWWWPW
WPPPPPPPPPPPPPPPPPPPW
WWWWWWWWWWWWWWWWWWWWW
